-,-,-,-,-,-,-,-,-,-,-,-,-
-,-,-,-,-,-,-,-,-,-,-,-,-
-,-,-,7,-,-,-,-,-,7,-,-,-
-,-,-,7,-,-,-,-,-,7,-,-,-
-,-,-,-,7,-,-,-,7,-,-,-,-
-,-,-,-,7,-,-,-,7,-,-,-,-
-,-,-,8,8,8,8,8,8,8,-,-,-
-,-,-,8,8,8,8,8,8,8,-,-,-
-,-,8,8,4,8,8,8,4,8,8,-,-
-,-,8,8,4,8,8,8,4,8,8,-,-
-,8,8,8,8,8,8,8,8,8,8,8,-
-,8,8,8,8,8,8,8,8,8,8,8,-
-,8,8,8,8,8,8,8,8,8,8,8,-
-,8,-,8,8,8,8,8,8,8,-,8,-
-,8,-,8,-,-,-,-,-,8,-,8,-
-,8,-,8,-,-,-,-,-,8,-,8,-
-,-,-,8,8,-,-,-,8,8,-,-,-
-,-,-,8,8,-,-,-,8,8,-,-,-
