-,-,-,-,-,-,-,-,-,-,-,-,-
-,-,-,-,-,-,-,-,-,-,-,-,-
3,3,3,3,3,3,3,3,3,3,3,3,3
-,-,-,-,-,-,-,-,-,-,-,-,-
0,0,0,9,9,9,9,9,9,9,9,9,9
-,-,-,-,-,-,-,-,-,-,-,-,-
4,4,4,4,4,4,4,4,4,4,4,4,4
-,-,-,-,-,-,-,-,-,-,-,-,-
9,9,9,9,9,9,9,9,9,9,0,0,0
-,-,-,-,-,-,-,-,-,-,-,-,-
6,6,6,6,6,6,6,6,6,6,6,6,6
-,-,-,-,-,-,-,-,-,-,-,-,-
5,5,5,9,9,9,9,9,9,9,9,9,9
-,-,-,-,-,-,-,-,-,-,-,-,-
2,2,2,2,2,2,2,2,2,2,2,2,2
-,-,-,-,-,-,-,-,-,-,-,-,-
9,9,9,9,9,9,9,9,9,9,2,2,2
