-,-,-,-,-,-,-,-,-,-,-
-,-,-,-,-,-,-,-,-,-,-
-,-,-,-,-,-,-,-,-,-,-
8,8,8,8,8,8,8,8,8,8,8
4,4,4,4,4,4,4,4,4,4,4
7,7,7,7,7,7,7,7,7,7,7
5,5,5,5,5,5,5,5,5,5,5
6,6,6,6,6,6,6,6,6,6,6
3,3,3,3,3,3,3,3,3,3,3
