-,-,-,-,-,-,-,-,-,-,-,-,-
-,-,-,-,-,-,-,-,-,-,-,-,-
-,-,-,-,-,-,-,-,-,-,-,-,-
-,-,-,-,-,-,-,-,-,-,-,-,-
-,1,2,3,8,5,-,7,0,1,2,3,-
-,2,3,8,5,6,-,0,1,2,3,8,-
-,3,8,5,6,7,-,1,2,3,8,5,-
-,8,5,6,7,0,-,2,3,8,5,6,-
-,5,6,7,0,1,-,3,8,5,6,7,-
-,6,7,0,1,2,-,8,5,6,7,0,-
-,7,0,1,2,3,-,5,6,7,0,1,-
-,0,1,2,3,8,-,6,7,0,1,2,-
-,1,2,3,8,5,-,7,0,1,2,3,-
-,2,3,8,5,6,-,0,1,2,3,8,-
-,3,8,5,6,7,-,1,2,3,8,5,-
-,8,5,6,7,0,-,2,3,8,5,6,-
-,5,6,7,0,1,-,3,8,5,6,7,-
-,6,7,0,1,2,-,8,5,6,7,0,-
